00000000000000000001
00101111101111110001
00100110100001000001
00100100111111111111
00111100010000111010
00000000011000100010
01010111011100110010
01110101001000100010
00100101101000111100
01100100101100100100
01011101100100100100
01110000000111111110
01001111111110000100
11000100000100000100
10011111000100111100
10010001011100100100
10011011010100000100
10001010010111111100
11111011110010010000
10000000000000000000
