00000000000000000111
00011111111110010100
00010000100010010100
01111111111111110100
01000100010000000100
01000100010000000100
01000100010000000100
01000100010000000100
01111111111111111100
01000100010000000100
01000111111111111100
01000100010000000100
01111111110111111100
01000100010100000100
01000100011111111100
01111111110000000100
01000100010011110100
01000100010010000100
11111111111110000100
10000000000000000000
