00000000000000111111
01111111111111100010
01010000101000101110
01011100111000101010
01010111100111111110
01010000100100000000
01010011100100000000
01000000000111111110
01111111111100000010
00000001000010010010
00000001000011111110
00000001000000000000
00011111111111111110
00010000000000000010
00010111111111111010
00010100000000001010
11110101111111111010
10000100000000000010
10000111111111111110
10000000000000000000
