00000000000000000011
00110000011101010010
00101110100111011010
00101011101101110010
00101010101011001110
00111011001010010010
00101010111011110110
00111010010110001010
01101111111001011110
01000010001101001010
01110110100101101110
00011101010101011010
01110101010111101110
01000101110000101000
01111001011111101000
01000111000001011100
11111001111111110100
10101000000100000100
10101111111111110110
10000000000000000000
