00000000000000111111
00000001111111100000
00000001000000100000
01111111000001100000
01000001111001000000
01000101001001000000
01000101011011000000
01111101000111111110
00000001000100000010
01111111111100000010
01000100010000001110
01110110011011101010
00010010000010100010
01110011111110100010
01000011000000100110
01110010000111100110
00000111000100001110
01111100001100001000
11000000000111111000
10000000000000000000
