00000000000000000011
00000000111100000110
00000000100100001100
00000000100100011000
00011111111111110000
00010000000001100000
00010000000011000000
00010000000111110000
00010000001100010000
00010000011000010000
00010000110000011110
00010001100000010010
00010011000000010010
00010110000000011110
00011100000000010000
00011000000000010000
00110000000000010000
01111111111111110000
11000000000000000000
10000000000000000000
