00000000000000001111
00000000000000001000
01111111111111111000
01000100001000001000
01111101101011001010
01010101001010111010
01010101001010100010
01111101001010100110
01010101111110100100
01010100000000111100
01010111111111100100
01111101000001000100
00000101001001000100
00100101111111000100
00100101000001000100
01111100000000000100
00000111111111111100
00000100000100010000
00000100000111110000
11111100000000000000
