00000000000000011111
00111111111101010000
00001000100111010000
00001001101101110000
00001000101011000000
00111111001010010000
00000000111011110000
00010000010110000000
00010001111001000000
00010000001101001110
00010000100101101100
00010000010101001000
00010000010111101000
00011111110000101000
00010000011111101000
00010000000001011100
00011110111111110100
00000110000100000100
00000000000111110110
11111111111100000000
